7 7
. . . # . . .
. # . # . # .
. # . . . # .
. # # # . # .
. . . . . # .
# # # # . # .
S . . . . . T
